####################
#..................#
#..####............#
#..................#
#..............#####
#..................#
#..######..........#
#..................#
####################