##############################################################################
#............................................................................#
#............................................................................#
#............................................................................#
#....#################################.......................................#
#............................................................................#
#............................................................................#
#.............................................#................###############
#.............................................#..............................#
#.............................................#..............................#
#.............................................#..............................#
#.............................................#..............................#
#.............................................#..............................#
#.............................................#..............................#
#.............................................#..............................#
#.............................................#..............................#
#.............................................#..............................#
#............................................................................#
#............................................................................#
#.............................................#..............................#
#.............................................#..............................#
##############################################################################